{
    "world": {
    
        "width": 20, "height": 150,
        
        "enemies": [
            {"x": 10,  "y":  30},
            {"x": 15,  "y":  40},
            {"x": 4,   "y":  50},
            {"x": 12,  "y":  60},
            {"x": 2,   "y":  70},
            {"x": 10,  "y":  80},
            {"x": 14,  "y":  90},
            {"x": 12,  "y": 100},
            {"x": 8,   "y": 110},
            {"x": 9,   "y": 120}
        ]
    }
}
